1111111111111111111111111111111111
110000000000000C00000C10H000H00011
1E10010100100000101111110010010001
101001000100101000110011100P010M01
100000000C10C0000000000000010000C1
1111111111111111111111111111111111
