1111111111111
10010000000C1
100H011111001
1P0011E00H001
1111111111111
