11111111111111111111111111111111111
111111111111111111111111100000001H1
1111111111111100H0000C11101110C0001
1C0000001110C0001111100110111111001
1M000P000H000110111111001C0010H0001
10000000111011101H0C111000100011011
11111100111011001010110011110111011
1111110C000000000010000111110111011
1111111110111101100010111111C0H0011
11111111001111011001100000000111011
1111111H001H1100H00H111011011111011
1HH000001000C1100110001011011111011
10011100100E00000110C000000000H0C11
10011100000000000000011111111111111
10C11100111111111111111111111111111
10000000111111111111111111111111111
11111111111111111111111111111111111
