1111111111111111111111111111111111111111111111111111111111111111
1111000000000000H00000000000000011111000000000001111111111111111
111C001111111110001111111001100C0111000C000000M01111111111111111
11100011111111110111111110011100001000001111100011111111110HH011
1H0000H00111111101111C0H10011110000000001111100011111111110C0011
1000000001111100000000000001111100001100011110001111111110011001
1111111000000H00111110000001111100001100001110000H0H000000011001
1111111000000000111110000111111100001100000110000000000000000001
1111111111111100111110001111111100001100000111111111111100111001
11111111111111000CH00001111111110000000000011111111111110C111001
1111111111111100000000011111111100000000000111111111111100111001
1111111111111100111110011111111100001100000111111111100000000001
1111111111111100111110011111111100001100000111111111100000000001
10000E0000HH0000000000011111111100001100000011111111100111111111
10C0P00000000000000000011110000000001100000000000000000111111111
1111000111111100111111111100000000001111000000000000000111111111
1111000111111100111110HH0000111111001111000011111001100111111111
1111000111111100111100000000111111001111000111111001100111111111
10H000000HH000000C00001111000H00H000000000011111100HH00111111111
1000000000000000000001111110000000000000000110C00000000111111111
1111111111111111111111111111111111111111111111111111111111111111
