1111111111111111111111111111111111111111111111111111111111111111
10C0000011111111111111110000000000000C0000000000001C0HH001111111
111111101111C000011111000000000000000000000000000010111101111111
11111110111111110H111H011111111111111001111111111110111101111111
1C00111011111111100100111111111111111001111111111110000000000111
1000111011111111110001111111111100001000H00111111111111111110111
10001110111111111110111111111111C0001111110111111H11111111110111
1000111011111111111011111111111100001111110111110E01111111110111
100011101111111111101111111111111110111111011110000000000H010111
1000111011111111111011111111111111101111110111101111011100010111
10000H000000000000HPH0000000000000H0H000000000001111011100010111
111111111111111111101111111111111111111111111111111101110C010111
111111111111111111101111111111111111111111111000000H0H010001C111
1111111111111111111011111110001111000000000000111111010111110111
1H0H111111111111111011111100100111011111111111111111010111110111
100000000000000000001C00H0011100H00100H11H0011111111010111110111
1001101111101111111011111111111111110111111011111111010111110111
1001101111101111111011111111111111110111111000000000010111110111
100000000H1010000C1000000000000000000000000011111111110111110111
100000000000001111111111111111111111111111111C000H000000000000M1
1111111111111111111111111111111111111111111111111111111111111111
