1111111111111111111111111111111111
110000000000000C00000C00H000H00011
1E100101001000001010010100P00100M1
1010010001001010001001000000010001
100000000C10C0000000000000010000C1
1111111111111111111111111111111111
