1111111111111111111111111111111111111111111111111111111111111111
1000000000000000000000000000000000000000000000000000000000000001
1000000000000000000000000000000000000000000000000000000000000001
1111111111111111111111111111111111111111111111111111111111111111
1111111111111111111111111111111111111111111111111111111111111111
11110000000000000000000000000000000000000000C0011111111100000001
111000000000000000000000000000000000000000000C000111111100000001
11CP0EC000000000000000000000000000000000000000000001111110000001
10000C0011111111111111111111111111111111111110000000011110000001
100C00111111111111111111111111111111111111111110000C000110000001
10C0011111111111111111111111111111111111111111110000C00110000001
10C0011111111111111111111111111111111111111111110000C00110000001
10C001111111110000000000000000000000000011111110000C000110000001
100C001111111111111111111111111111111111111110000000011110000001
1000C00000111111111111111111111111111111110000000001111110000001
111000000C000000000000000000000000000000000000000111111110000001
1111000000CC00000000000M0000000000000000000000011111111110000001
1111110000000000000000000000000000000000000001111110000110000001
1111111111111111111111111111111111111111111111111000000110000001
1111111111111111111111111111111111111111111111100000000110000001
1111111111111111111111111111111111111111111111111111111111111111
